THE OSCARS TURN  ON SUNDAY WHICH SEEMS ABOUT RIGHT AFTER THIS |	THE OSCARS TURN  ON SUNDAY WHICHƒ0‚Ÿ|¬√‚Ø	ÅΩ4HT AFTER THIS LONG S
AWARDS TRIP THE BAGGER FEELS LIKE A NONAGENARIAN TOO		AWARDS TRIP THE BAGGER FEELS LIKE A NONAGENARIAN TOO

THE AWARDS RACE WAS BOOKENDED BY THE DEMISE OF HARVEY WEINSTE	THE AWARDS RACE WAS BOOKENDED BY THE DEMISE OF HARVEY WEINSTE
AND THE APPARENT IMPLOSION OF HIS FILM COMPANY AT THE END AND	AND THE APPARENT IMPLOSION OF HIS FILM COMPANY AT THE END AND
THE EMERGENCE OF METOO TIMES UP BLACKGOWN POLITICS ARMCANDY A	THE EMERGENCE OF METOO TIMES UP BLACKGOWN POLITICS ARMCANDY A
A NATIONAL CONVERSATION AS BRIEF AND MAD AS A FEVER DREAM ABO	A NATIONAL CONVERSATION AS BRIEF AND MAD AS A FEVER DREAM ABO
OUGHT TO BE A PRESIDENT WINFREY THE SEASON DIDNT JUST SEEM EX	OUGHT TO BE A PRESIDENT WINFREY THE SEASON DIDNT JUST SEEM EX
EXTRA LONG BECAUSE THE OSCARS WERE MOVED TO THE FIRST WEEKEND	EXTRA LONG BECAUSE THE OSCARS WERE MOVED TO THE FIRST WEEKEND
AVOID CONFLICTING WITH THE CLOSING CEREMONY OF THE WINTER OLY	AVOID CONFLICTING WITH THE CLOSING CEREMONY OF THE WINTER OLY
PYEONGCHANG							PYEONGCHANG

ONE BIG QUESTION SURROUNDING THIS YEARS ACADEMY AWARDS IS HOW	ONE BIG QUESTION SURROUNDING THIS YEARS ACADEMY AWARDS IS HOW
CEREMONY WILL ADDRESS METOO ESPECIALLY AFTER THE GOLDEN GLOBE	CEREMONY WILL ADDRESS METOO ESPECIALLY AFTER THE GOLDEN GLOBE
A JUBILANT COMINGOUT PARTY FOR TIMES UP THE MOVEMENT SPEARHEA	A JUBILANT COMINGOUT PARTY FOR TIMES UP THE MOVEMENT SPEARHEA
POWERFUL HOLLYWOOD WOMEN WHO HELPED RAISE MILLIONS OF DOLLARS	POWERFUL HOLLYWOOD WOMEN WHO HELPED RAISE MILLIONS OF DOLLARS
HARASSMENT AROUND THE COUNTRY					HARASSMENT AROUND THE COUNTRY

SIGNALING THEIR SUPPORT GOLDEN GLOBES ATTENDEES SWATHED THEMS	SIGNALING THEIR SUPPORT GOLDEN GLOBES ATTENDEES SWATHED THEMS
SPORTED LAPEL PINS AND SOUNDED OFF ABOUT SEXIST POWER IMBALAN	SPORTED LAPEL PINS AND SOUNDED OFF ABOUT SEXIST POWER IMBALAN
CARPET AND THE STAGE ON THE AIR E WAS CALLED OUT ABOUT PAY IN	CARPET AND THE STAGE ON THE AIR E WAS CALLED OUT ABOUT PAY IN
ITS FORMER ANCHOR CATT SADLER QUIT ONCE SHE LEARNED THAT SHE 	ITS FORMER ANCHOR CATT SADLER QUIT ONCE SHE LEARNED THAT SHE 
LESS THAN A MALE COHOST AND DURING THE CEREMONY NATALIE PORTM	LESS THAN A MALE COHOST AND DURING THE CEREMONY NATALIE PORTM
AND SATISFYING DIG AT THE ALLMALE ROSTER OF NOMINATED DIRECTO	AND SATISFYING DIG AT THE ALLMALE ROSTER OF NOMINATED DIRECTO
THAT BE TOPPED							THAT BE TOPPED

AS IT TURNS OUT AT LEAST IN TERMS OF THE OSCARS IT PROBABLY W	AS IT TURNS OUT AT LEAST IN TERMS OF THE OSCARS IT PROBABLY W

WOMEN INVOLVED IN TIMES UP SAID THAT ALTHOUGH THE GLOBES SIGN	WOMEN INVOLVED IN TIMES UP SAID THAT ALTHOUGH THE GLOBES SIGN
INITIATIVES LAUNCH THEY NEVER INTENDED IT TO BE JUST AN AWARD	INITIATIVES LAUNCH THEY NEVER INTENDED IT TO BE JUST AN AWARD
CAMPAIGN OR ONE THAT BECAME ASSOCIATED ONLY WITH REDCARPET AC	CAMPAIGN OR ONE THAT BECAME ASSOCIATED ONLY WITH REDCARPET AC
A SPOKESWOMAN SAID THE GROUP IS WORKING BEHIND CLOSED DOORS A	A SPOKESWOMAN SAID THE GROUP IS WORKING BEHIND CLOSED DOORS A
AMASSED  MILLION FOR ITS LEGAL DEFENSE FUND WHICH AFTER THE G	AMASSED  MILLION FOR ITS LEGAL DEFENSE FUND WHICH AFTER THE G
FLOODED WITH THOUSANDS OF DONATIONS OF  OR LESS FROM PEOPLE I	FLOODED WITH THOUSANDS OF DONATIONS OF  OR LESS FROM PEOPLE I
COUNTRIES							COUNTRIES


NO CALL TO WEAR BLACK GOWNS WENT OUT IN ADVANCE OF THE OSCARS	NO CALL TO WEAR BLACK GOWNS WENT OUT IN ADVANCE OF THE OSCARS
MOVEMENT WILL ALMOST CERTAINLY BE REFERENCED BEFORE AND DURIN	MOVEMENT WILL ALMOST CERTAINLY BE REFERENCED BEFORE AND DURIN
ESPECIALLY SINCE VOCAL METOO SUPPORTERS LIKE ASHLEY JUDD LAUR	ESPECIALLY SINCE VOCAL METOO SUPPORTERS LIKE ASHLEY JUDD LAUR
NICOLE KIDMAN ARE SCHEDULED PRESENTERS				NICOLE KIDMAN ARE SCHEDULED PRESENTERS

ANOTHER FEATURE OF THIS SEASON NO ONE REALLY KNOWS WHO IS GOI	ANOTHER FEATURE OF THIS SEASON NO ONE REALLY KNOWS WHO IS GOI
PICTURE ARGUABLY THIS HAPPENS A LOT OF THE TIME INARGUABLY TH	PICTURE ARGUABLY THIS HAPPENS A LOT OF THE TIME INARGUABLY TH
NARRATIVE ONLY SERVES THE AWARDS HYPE MACHINE BUT OFTEN THE P	NARRATIVE ONLY SERVES THE AWARDS HYPE MACHINE BUT OFTEN THE P
THE RACE SOCALLED OSCAROLOGISTS CAN MAKE ONLY EDUCATED GUESSE	THE RACE SOCALLED OSCAROLOGISTS CAN MAKE ONLY EDUCATED GUESSE

THE WAY THE ACADEMY TABULATES THE BIG WINNER DOESNT HELP IN E	THE WAY THE ACADEMY TABULATES THE BIG WINNER DOESNT HELP IN E
CATEGORY THE NOMINEE WITH THE MOST VOTES WINS BUT IN THE BEST	CATEGORY THE NOMINEE WITH THE MOST VOTES WINS BUT IN THE BEST
CATEGORY VOTERS ARE ASKED TO LIST THEIR TOP MOVIES IN PREFERE	CATEGORY VOTERS ARE ASKED TO LIST THEIR TOP MOVIES IN PREFERE
MOVIE GETS MORE THAN  PERCENT OF THE FIRSTPLACE VOTES IT WINS	MOVIE GETS MORE THAN  PERCENT OF THE FIRSTPLACE VOTES IT WINS
MOVIE MANAGES THAT THE ONE WITH THE FEWEST FIRSTPLACE VOTES I	MOVIE MANAGES THAT THE ONE WITH THE FEWEST FIRSTPLACE VOTES I
ITS VOTES ARE REDISTRIBUTED TO THE MOVIES THAT GARNERED THE E	ITS VOTES ARE REDISTRIBUTED TO THE MOVIES THAT GARNERED THE E
SECONDPLACE VOTES AND THIS CONTINUES UNTIL A WINNER EMERGES	SECONDPLACE VOTES AND THIS CONTINUES UNTIL A WINNER EMERGES

IT IS ALL TERRIBLY CONFUSING BUT APPARENTLY THE CONSENSUS FAV	IT IS ALL TERRIBLY CONFUSING BUT APPARENTLY THE CONSENSUS FAV
AHEAD IN THE END THIS MEANS THAT ENDOFSEASON AWARDS CHATTER I	AHEAD IN THE END THIS MEANS THAT ENDOFSEASON AWARDS CHATTER I
INVOLVES TORTURED SPECULATION ABOUT WHICH FILM WOULD MOST LIK	INVOLVES TORTURED SPECULATION ABOUT WHICH FILM WOULD MOST LIK
SECOND OR THIRD FAVORITE AND THEN EQUALLY TORTURED CONCLUSION	SECOND OR THIRD FAVORITE AND THEN EQUALLY TORTURED CONCLUSION
FILM MIGHT PREVAIL						FILM MIGHT PREVAIL

IN  IT WAS A TOSSUP BETWEEN BOYHOOD AND THE EVENTUAL WINNER B	IN  IT WAS A TOSSUP BETWEEN BOYHOOD AND THE EVENTUAL WINNER B
IN  WITH LOTS OF EXPERTS BETTING ON THE REVENANT OR THE BIG S	IN  WITH LOTS OF EXPERTS BETTING ON THE REVENANT OR THE BIG S
PRIZE WENT TO SPOTLIGHT LAST YEAR NEARLY ALL THE FORECASTERS 	PRIZE WENT TO SPOTLIGHT LAST YEAR NEARLY ALL THE FORECASTERS 
LA LAND THE PRESUMPTIVE WINNER AND FOR TWO AND A HALF MINUTES	LA LAND THE PRESUMPTIVE WINNER AND FOR TWO AND A HALF MINUTES
CORRECT BEFORE AN ENVELOPE SNAFU WAS REVEALED AND THE RIGHTFU	CORRECT BEFORE AN ENVELOPE SNAFU WAS REVEALED AND THE RIGHTFU
MOONLIGHT WAS CROWNED						MOONLIGHT WAS CROWNED

THIS YEAR AWARDS WATCHERS ARE UNEQUALLY DIVIDED BETWEEN THREE	THIS YEAR AWARDS WATCHERS ARE UNEQUALLY DIVIDED BETWEEN THREE
OUTSIDE EBBING MISSOURI THE FAVORITE AND THE SHAPE OF WATER W	OUTSIDE EBBING MISSOURI THE FAVORITE AND THE SHAPE OF WATER W
THE BAGGERS PREDICTION WITH A FEW FORECASTING A HAIL MARY WIN	THE BAGGERS PREDICTION WITH A FEW FORECASTING A HAIL MARY WIN

BUT ALL OF THOSE FILMS HAVE HISTORICAL OSCARVOTING PATTERNS A	BUT ALL OF THOSE FILMS HAVE HISTORICAL OSCARVOTING PATTERNS A
SHAPE OF WATER HAS  NOMINATIONS MORE THAN ANY OTHER FILM AND 	SHAPE OF WATER HAS  NOMINATIONS MORE THAN ANY OTHER FILM AND 
NAMED THE YEARS BEST BY THE PRODUCERS AND DIRECTORS GUILDS YE	NAMED THE YEARS BEST BY THE PRODUCERS AND DIRECTORS GUILDS YE
NOMINATED FOR A SCREEN ACTORS GUILD AWARD FOR BEST ENSEMBLE A	NOMINATED FOR A SCREEN ACTORS GUILD AWARD FOR BEST ENSEMBLE A
WON BEST PICTURE WITHOUT PREVIOUSLY LANDING AT LEAST THE ACTO	WON BEST PICTURE WITHOUT PREVIOUSLY LANDING AT LEAST THE ACTO
SINCE BRAVEHEART IN  THIS YEAR THE BEST ENSEMBLE SAG ENDED UP	SINCE BRAVEHEART IN  THIS YEAR THE BEST ENSEMBLE SAG ENDED UP
THREE BILLBOARDS WHICH IS SIGNIFICANT BECAUSE ACTORS MAKE UP 	THREE BILLBOARDS WHICH IS SIGNIFICANT BECAUSE ACTORS MAKE UP 
LARGEST BRANCH THAT FILM WHILE DIVISIVE ALSO WON THE BEST DRA	LARGEST BRANCH THAT FILM WHILE DIVISIVE ALSO WON THE BEST DRA
AND THE BAFTA BUT ITS FILMMAKER MARTIN MCDONAGH WAS NOT NOMIN	AND THE BAFTA BUT ITS FILMMAKER MARTIN MCDONAGH WAS NOT NOMIN
DIRECTOR AND APART FROM ARGO MOVIES THAT LAND BEST PICTURE WI	DIRECTOR AND APART FROM ARGO MOVIES THAT LAND BEST PICTURE WI
EARNING BEST DIRECTOR NOMINATIONS ARE FEW AND FAR BETWEEN	EARNING BEST DIRECTOR NOMINATIONS ARE FEW AND FAR BETWEEN




